Your decoded message is: Ttkmxx	Ahltgxx
Texq	Utchak
Texqbl	Yehkxl
Teblhg	Dxxgtg
Tgwr	Znxotkt
Tggt	Utkhgldr
Tgmahgr	Tgwxklhg
Tkcng	Uatg
Ukbtg	Zhnew
Ukhhdx	Lvneer
Vatkebx	Likxwt
Wxtg	Tgwktwx
Whghotg	Lhnvr
Xfft	Ynkznxlhg
Xotg	Zhewlfbma
Atgz	Gznrxg
Botg	Znxkkxkh
Ctdx	Vhkvhktg
Ctdx	H'Ukbxg
Ctfxl	Tgwkxp
Ctr	Rngtl
Cnebt	Zktatf
Cnebtgt	ExUetgv
Dxobg	Oxgmnkt Jnbctwt
Dbfuxker	Kbotl
Dkblmbg	Axll
Ebgwt	Ax
Ftvdxgsbx	Ftkobg
Fw	Ctptw
Fbt Gztg	Gznrxg
Fbvaxeex	Ybznxkht
Fbrt	Vhaxg
Fhkztg	Utnzaftg
Fnatfftw	Tafxw
Gbvahetl	Fneebg
Gbvd	Etxsst
Gbdxla	Zabfbkx
Gbdhetl	Lxoxkbgh
Khuxkm	Cxglxg
Laxkkr	Zth
Lanftbe	Tsbs
Lbfhg	Fhkxbkt
Lmxytg	Ztkuxx
Mrexk	Lbeuxr
Pbeebtf	Uxwyhkw
Prgmkx	Ykbxl
Stvatkr	Uxnvexk
Stvatkr	Znlmtylhg